刘恒君	CEPC上H→bˉb/cˉc/gg衰变分支比的研究	熊庄
何明	Weyl半金属超导结输运性的研究		汪军
李政楠	二维氧化SiS结构的稳定性和电学性质的研究	董帅
石雨豪	量子行走搜索算法在计算科学中的应用研究	薛鹏
谢美花	二维有机无机杂化及全无机钙钛矿的设计与稳定性研究	王金兰
徐梦妍	宏观实在性与Leggett-Garg不等式的实验验证	薛鹏
秦玲瑶	水热法制备FeSe1-xSx超导单晶及其电、磁性质研究	徐明祥
高世玲	具有PT对称量子行走的实验研究	杨永宏
周义	几类新颖的有限背景光孤子及其相互作用研究	陈世华
张瑞	类粲偶素的衰变性质研究	周智勇
李宁	复合纳米结构的水热合成及其光催化性质研究	洪昆权
樊博文	加强型海森堡不确定关系的实验验证	薛鹏
陈月	高分辨率迁移率谱对大磁电阻材料的研究	施智祥
王维正	有机铅卤钙钛矿胶体纳米晶的制备与自组织生长	范吉阳
张卿雅	固态光学腔量子系统中三阶光学非线性及其调控	杨文星
张雅茜	石墨烯特异材料中磁涡旋共振的研究	董正高
赵东翔	Bethe-Salpeter方程到薛定谔方程	周海清
史倩仪	基于层结构人工介质的单方向电磁传输特性研究	王进
顾超	Au–ZnO异质纳米结构的制备及光学性质研究	范吉阳
王媛婷	锂/钠离子电池正极材料的研究	徐庆宇
林谦	二维材料的紫外臭氧改性及光学性质研究	倪振华
袁嘉	标准宇宙学中慢滚暴胀模型的研究	吕准
刘孟瑶	Dion-Jacobson层状钙钛矿氧化物新材料的合成及其性能的研究	唐雁坤
丁然	二维过渡金属硫族化合物的生长及电催化性能研究	洪昆权
杨翠苹	磷烯线缺陷的理论研究	侯净敏
米伟	过渡金属氟化物的物性研究	李旗
张珍珍	铁磁/非磁自旋泵浦效应的研究	翟亚
杨娟	应力对二维材料调控的第一性原理研究	熊庄
贾西月	11 体系铁基超导材料的制备及掺杂研究	李旗
梁艳平	双钙钛矿Ba2MnTeO6的磁性研究	董帅
徐彪	载流子传输层和阻变效应对BiFeO3薄膜光伏效应影响的研究	徐庆宇
陈杏梅	二维SiP新结构的预测	侯净敏
荆启华	ReS2纳米片的制备及其异质结光催化性能研究	邱腾
