童雪	N等离子体处理ZnO基半导体材料的铁磁性增强	徐庆宇
余婷洁	用COMSOL对自制的PCF的理论仿真	吕准
何琳萍	1S0态类氢原子能谱的相对论修正	侯净敏
韩瑜	基于对称性的晶体结构生成	董帅
杨康	基于光学系统的神经网络初步研究	李家奇
马眉扬	MoSe2稳态和瞬态电子能带结构的探测研究	翟亚
孙宇	铁基超导材料的水热法制备及其物性研究	施智祥
石成林	贵金属纳米颗粒-微腔耦合系统光学非线性增强	杨文星
吴宇	双钙钛矿多铁性材料的制备和性能表征	李旗
陈俊	第二类外尔半金属WTe2器件制备和输运性质研究	施智祥
谢佳辰	磁性坡莫合金薄膜基自旋相关器件的输运性质的研究	翟亚
高柏植	带自旋粒子的世界线及其全息对偶量	许剑飞
孟珂	电弧炉熔炼法制备超导合金	施智祥
马宇星	Ca掺杂的LaCrO3磁性及电子结构的第一性原理计算	董帅
余承涌	低维超导材料的氢化研究	施智祥
李伦	基于强自旋轨道耦合材料的电学性质研究	吕准
余浩斌	对具有吸引相互作用的skyrmion动力学性质的模拟研究	赵海军
刘文博	MoS2的拉曼光谱计算	张道宇
杨家甫	多体相空间的高精度数值计算	周海清
贺宇辰	一种基于声呐成像传感器的研究	徐庆宇
章晋国	高性能锂电池硫电极的制备	徐庆宇
李聿安	藻类微生物趋光反应的运动分析	倪振华
李凯	三氟化硼（BF3）气体的电离过程探究	施智祥
戴天时	光学Tamm态的研究	喻小强
黄菊	添加表面活性剂降低YIG的烧结温度	徐庆宇
黄珺晗	La2-xSrxNiRuO6新体系材料的研究	徐明祥
尹璐	面向高质量发展的交通系统优化设计方法	林宏志
慕钊辰	半导体复合纳米结构的制备及其光催化应用	洪昆权
谢亭玉	等离子体处理界面对有机钙钛矿太阳能电池效率的影响	徐庆宇
李天睿	新型准一维硫族化合物超导材料的探索与研究	施智祥
贾钊滢	还原气氛和温度对刚玉晶体着色的工艺影响	翟亚
唐枭	基于钙钛矿薄膜的表面增强拉曼散射活性基底研究	邱腾
王世益	光力阵列中的拓扑相	侯净敏
丁哲楷	二维材料的表面修饰与性能调控	管杰
王子凡	BCD函数在非物理区域性质的讨论	周海清
洪振坤	双钙钛矿La2-xSrxMnRuO6的制备和物性	徐明祥
王昕韬	交联型金属氧化物气凝胶在催化体系的应用研究	范奇
李新新	基于片上氧化硅回音壁模光学微腔的孤子频率梳产生	范吉阳
李剑歌	类氢原子体系Bethe-Salpeter方程的三维约化	侯净敏
蒋兆涵	超越衍射极限的运动原子高精度空间局域化	杨文星
韩诚	硫化物纳米薄膜的制备及其电催化性能	洪昆权
吴乔毅	二维材料MoS2的可调控电子性质	张道宇
薛丰铧	磁性异质结的磁光克尔成像研究	徐庆宇
秦鑫	磁光克尔效应的测量	董帅
康银良	全无机钙钛矿纳米结构形貌调控	吕俊鹏
袁俊翔	复合超材料中旋光效应的仿真研究	董正高
罗立瑞	Dion-Jacobson层状材料的铁电性研究	彭劲
陈俊雄	高性能阳离子无序氧化物锂电池电极材料的制备	徐庆宇
张亮	交联型金属氧化物气凝胶的制备及应用研究	范奇
徐磊	超材料电磁吸收器原理及应用	董正高
高翔	人体胃癌组织的太赫兹研究	陈华
周方坤	超导材料的制备和电子结构研究	李旗
许子川	多铁性薄膜及其异质结的制备和性能研究	李旗
刘斯琦	Gm-C滤波器中高线性度Gm模块设计	吴旭
隋新春	贵金属纳米颗粒调控共振荧光	杨文星
宋家兴	类石墨相氮化碳的制备及光催化性质	洪昆权
窦唯靖	基于SOSVM的事件预检测算法研究	谢利萍